1111111111111111111111111111111111111111111111111111111111111111111111111111111111111111114
1111111111111111111111111111111111111111111111111111111111111111111111111111111111111111114
1111111111111111111111111111111111111111111111111111111111111111111111111111111111111111114
1111111111111111111111111111111111111111111111111111111111111111111111111111111111111111114
1111111111111111111111111111111111111111111111111111111111111111111111111111111111111111114
1111111111111111111111111111111111111111111111111111111111111111111111111111111111111111114
1111111111111111111111111111111111111111111111111111111111111111111111111111111111111111114
1111111111111111111111111111111111111111111111111111111111111111111111111111111111111111114
1111111111111111111111111111111111111111111111111111111111111111111111111111111111111111114
1111111111111111111111122222222222222111111111111111111111111111111111111111111111111111114
1111111111111111111111111111111111111111111111111111111111111111111111111111111111111111114
1111111111111111111111111111111111111111111111111111111111111111111111111111111111111111114
1111111111111111111111111111111111111111111111111111111111111111111111111111111111111111114
1111111111111111111111111111111111111111111111111111111111111111111111111111111111111111114
1111111111111111111121111111111111111111111111111111111111111111111111111111111111111111114
1111111111111111111121111111111111111111111111111111111111111111111111111111111111111111114
1111111111111111111121111111111111111111211111111111111111111111111111111111111111111111114
1111111111111111111121111111111111111112321111111111111111111111111111111111111111111111114
1111111111111111111121111111111111111123332111111111111111111111111111111111111111111111114
1111111111111111111111111111111111111233333211111111111111111111111111111111111111111111114
1111111111111111111111211111111111111333333311111111111111111111111111111111111111111111114
1111111111111111111112211111111111111333333311111111111111111111111111111111111111111111114
1111111111111111111122211111111111112333333321111111111111111111111111111111111111111111114
2222222222222222222222222222222222223333333332222222222222222222222222222222222222222111114
2222222222222222222222222222223333333333333333333333333333333322222222222222221111111222224
3333333333333333333333333333333333333333333333333333333333333333333333333333333333333333334
3333333333333333333333333333333333333333333333333333333333333333333333333333333333333333334
3333333333333333333333333333333333333333333333333333333333333333333333333333333333333333334
3333333333333333333333333333333333333333333333333333333333333333333333333333333333333333334
3333333333333333333333333333333333333333333333333333333333333333333333333333333333333333334
3333333333333333333333333333333333333333333333333333333333333333333333333333333333333333334
3333333333333333333333333333333333333333333333333333333333333333333333333333333333333333334
3333333333333333333333333333333333333333333333333333333333333333333333333333333333333333334
3333333333333333333333333333333333333333333333333333333333333333333333333333333333333333334
3333333333333333333333333333333333333333333333333333333333333333333333333333333333333333334
3333333333333333333333333333333333333333333333333333333333333333333333333333333333333333334